# 生協・食堂
こうこうしゃ	皎皎舎	名詞
ていていしゃ	亭亭舎	名詞
びっぐどら	ビッグどら	名詞
びっぐさんど	ビッグさんど	名詞
ちかしょく	地下食堂	名詞
# Commons
おうめいてんくうひろば	嚶鳴天空広場	名詞
# 図書館
りけと	りけと	名詞
りけと	理系図書館	名詞
ちゅうと	中央図書館	名詞
# 寮
いときょうそうかん	伊都協奏館	名詞
きょうそうかん	協奏館	名詞
# 九州大学
きゅうだい	九大	名詞
きゅうだい	九州大学	名詞
きゅうだいせい	九大生	名詞
きゅうだいさい	九大祭	名詞
# 芸術工学部
げいこう	芸工	名詞
げいこう	芸術工学部	名詞
